WWWWWWWWWWWWWWWWWWWWWWWW
WWWWWWWPHPPWWWWWWWWWWWWW
WWWWPPPPWWPWWWWWWWWWWWWW
WWWWPWWWWWPWWWWWWPPPPPPS
WWWWPWWWWWPWWWWWWPWWWWWW
WWWWHWWWWWPPPWWWPPWWWWWW
WWWWPWWWWWPPHWWWPWWWWWWW
FPPPPWWWWWWWPPPPPWWWWWWW
WWWWWWWWWWWWWWWWWWWWWWWW
WWWWWWWWWWWWWWWWWWWWWWWW
WWWWWWWWWWWWWWWWWWWWWWWW
WWWWWWWWWWWWWWWWWWWWWWWW
